EndChar,SurnameCount,Female,Male,Gender,pVal
イ,3,3,0,f,0.00951321329921484
い,28,26,2,f,0.00100000004749745
う,3,1,2,b,0.510489940643311
え,35,35,0,f,0.00100000004749745
お,6,2,4,b,0.373838186264038
カ,10,7,3,f,0.00124697247520089
か,90,89,1,f,0.00100000004749745
キ,10,7,3,f,0.00124697247520089
き,108,98,10,f,0.00100000004749745
く,2,2,0,f,0.044897086918354
コ,6,6,0,f,9.05012275325134E-05
こ,35,34,1,f,0.00100000004749745
サ,4,3,1,f,0.0320056080818176
さ,30,29,1,f,0.00100000004749745
し,16,0,16,m,0.0221511032432318
ス,5,2,3,b,0.287234365940094
ず,2,2,0,f,0.044897086918354
せ,5,5,0,f,0.000427115563070402
ち,5,1,4,b,0.712765634059906
つ,5,2,3,b,0.287234365940094
と,6,5,1,f,0.0021101871971041
な,24,24,0,f,0.00100000004749745
ぬ,2,2,0,f,0.044897086918354
ね,13,13,0,f,1.73547376469685E-09
の,6,6,0,f,9.05012275325134E-05
ぶ,21,21,0,f,7.05164923577983E-15
ほ,13,13,0,f,1.73547376469685E-09
マ,2,1,1,b,0.378881573677063
ミ,18,18,0,f,7.41247883385976E-13
み,382,381,1,f,0.00100000004749745
む,3,1,2,b,0.510489940643311
め,4,4,0,f,0.00201574829407036
ヤ,2,1,1,b,0.378881573677063
や,9,8,1,f,2.96815142064588E-05
ゆ,3,3,0,f,0.00951321329921484
よ,8,8,0,f,4.06324170398875E-06
ラ,2,1,1,b,0.378881573677063
ら,22,21,1,f,1.237587235383E-13
リ,8,8,0,f,4.06324170398875E-06
り,266,265,1,f,0.00100000004749745
る,45,42,3,f,0.00100000004749745
れ,6,6,0,f,9.05012275325134E-05
ろ,19,18,1,f,1.12565842064205E-11
ン,11,4,7,b,0.188417255878448
ん,5,2,3,b,0.287234365940094
亜,13,10,3,f,2.74982103292132E-05
愛,102,98,4,f,0.00100000004749745
葵,43,26,17,f,0.00100000004749745
茜,27,27,0,f,0.00100000004749745
旭,22,1,21,m,0.0367030426859856
梓,23,18,5,f,8.15007084042918E-09
絢,2,1,1,b,0.378881573677063
綾,35,34,1,f,0.00100000004749745
安,13,1,12,b,0.203412413597107
杏,6,6,0,f,9.05012275325134E-05
以,8,5,3,f,0.0134072359651327
伊,3,2,1,b,0.115664832293987
依,21,21,0,f,7.05164923577983E-15
威,14,1,13,b,0.169899821281433
惟,6,4,2,f,0.0208904650062323
衣,97,96,1,f,0.00100000004749745
育,6,1,5,b,0.626161813735962
郁,32,10,22,b,0.899999976158142
一,3508,1,3507,m,0.00100000004749745
宇,8,1,7,b,0.468950062990189
羽,28,20,8,f,0.00100000004749745
映,7,6,1,f,0.000518451153766364
栄,74,27,47,f,0.0020000000949949
永,35,8,27,b,0.899999976158142
瑛,12,3,9,b,0.483409285545349
英,166,17,149,m,0.00100000004749745
衛,34,0,34,m,0.00300000002607703
悦,13,1,12,b,0.203412413597107
円,15,9,6,f,0.00122140685562044
園,2,2,0,f,0.044897086918354
延,13,0,13,m,0.0452515780925751
縁,2,2,0,f,0.044897086918354
央,180,50,130,f,0.0320000015199184
温,11,2,9,b,0.577963352203369
音,68,48,20,f,0.00100000004749745
伽,3,2,1,b,0.115664832293987
佳,258,206,52,f,0.00100000004749745
加,73,69,4,f,0.00100000004749745
可,7,3,4,b,0.169078007340431
嘉,29,3,26,b,0.899999976158142
夏,64,62,2,f,0.00100000004749745
果,11,11,0,f,3.86544840580427E-08
架,2,1,1,b,0.378881573677063
歌,9,8,1,f,2.96815142064588E-05
河,16,0,16,m,0.0221511032432318
花,97,96,1,f,0.00100000004749745
華,77,76,1,f,0.00100000004749745
芽,5,4,1,f,0.00837027933448553
賀,13,10,3,f,2.74982103292132E-05
雅,100,3,97,m,0.00100000004749745
介,1230,0,1230,m,0.00100000004749745
海,92,29,63,f,0.0160000007599592
絵,102,102,0,f,0.00100000004749745
馨,21,1,20,m,0.0447601974010468
格,14,0,14,m,0.0356632508337498
覚,32,0,32,m,0.00400000018998981
学,197,0,197,m,0.00100000004749745
岳,31,0,31,m,0.00499999988824129
楽,9,2,7,b,0.598879456520081
寛,220,0,220,m,0.00100000004749745
幹,31,0,31,m,0.00499999988824129
環,8,3,5,b,0.229819104075432
巌,18,0,18,m,0.0137584581971169
喜,173,10,163,m,0.00100000004749745
基,155,0,155,m,0.00100000004749745
岐,6,2,4,b,0.373838186264038
希,380,159,221,f,0.00100000004749745
揮,20,0,20,m,0.00854563154280186
毅,186,0,186,m,0.00100000004749745
気,34,0,34,m,0.00300000002607703
季,63,43,20,f,0.00100000004749745
稀,16,7,9,f,0.0357827581465244
紀,765,328,437,f,0.00100000004749745
規,120,1,119,m,0.00100000004749745
記,67,5,62,m,0.00700000021606684
貴,535,48,487,m,0.00100000004749745
起,38,7,31,b,0.899999976158142
輝,446,5,441,m,0.00100000004749745
宜,31,0,31,m,0.00499999988824129
義,249,0,249,m,0.00100000004749745
吉,67,0,67,m,0.00100000004749745
久,590,2,588,m,0.00100000004749745
弓,77,76,1,f,0.00100000004749745
亨,73,0,73,m,0.00100000004749745
享,22,0,22,m,0.00530784949660301
京,10,3,7,b,0.358322262763977
匡,21,0,21,m,0.00673490390181541
喬,13,0,13,m,0.0452515780925751
強,22,0,22,m,0.00530784949660301
恭,27,1,26,m,0.0270000007003546
教,28,0,28,m,0.00700000021606684
興,22,0,22,m,0.00530784949660301
鏡,2,1,1,b,0.378881573677063
響,9,1,8,b,0.401120543479919
暁,41,2,39,m,0.0109999999403954
玉,3,1,2,b,0.510489940643311
均,61,0,61,m,0.00100000004749745
欣,4,1,3,b,0.614211916923523
琴,18,15,3,f,3.27427933655144E-08
銀,2,1,1,b,0.378881573677063
玖,7,2,5,b,0.455742239952087
空,29,14,15,f,0.00100000004749745
勲,61,0,61,m,0.00100000004749745
薫,136,53,83,f,0.00100000004749745
訓,30,0,30,m,0.00499999988824129
啓,109,2,107,m,0.00100000004749745
圭,55,4,51,m,0.0120000001043081
恵,560,543,17,f,0.00100000004749745
慶,48,0,48,m,0.00100000004749745
慧,24,1,23,m,0.0430000014603138
敬,105,1,104,m,0.00100000004749745
景,12,8,4,f,0.00087650801287964
桂,12,6,6,f,0.0255319830030203
継,22,0,22,m,0.00530784949660301
潔,44,0,44,m,0.00100000004749745
結,14,14,0,f,3.67728375527676E-10
月,67,58,9,f,0.00100000004749745
健,219,0,219,m,0.00100000004749745
建,14,0,14,m,0.0356632508337498
憲,152,0,152,m,0.00100000004749745
見,26,12,14,f,0.00300000002607703
謙,20,0,20,m,0.00854563154280186
賢,72,1,71,m,0.00100000004749745
顕,33,0,33,m,0.00400000018998981
元,66,0,66,m,0.00100000004749745
己,216,6,210,m,0.00100000004749745
湖,8,8,0,f,4.06324170398875E-06
伍,25,0,25,m,0.00999999977648258
吾,417,0,417,m,0.00100000004749745
悟,250,0,250,m,0.00100000004749745
瑚,2,2,0,f,0.044897086918354
護,17,1,16,b,0.0972484201192856
倖,2,2,0,f,0.044897086918354
光,320,11,309,m,0.00100000004749745
公,18,1,17,b,0.0803415775299072
功,109,0,109,m,0.00100000004749745
厚,29,0,29,m,0.00600000005215406
向,5,1,4,b,0.712765634059906
好,47,2,45,m,0.00499999988824129
孔,3,1,2,b,0.510489940643311
孝,426,0,426,m,0.00100000004749745
宏,826,1,825,m,0.00100000004749745
巧,49,0,49,m,0.00100000004749745
幸,1145,67,1078,m,0.00100000004749745
広,396,0,396,m,0.00100000004749745
康,168,0,168,m,0.00100000004749745
弘,1097,1,1096,m,0.00100000004749745
恒,22,0,22,m,0.00530784949660301
晃,253,3,250,m,0.00100000004749745
江,251,249,2,f,0.00100000004749745
浩,599,0,599,m,0.00100000004749745
紅,2,2,0,f,0.044897086918354
紘,25,6,19,b,0.899999976158142
航,41,0,41,m,0.00100000004749745
行,848,0,848,m,0.00100000004749745
貢,31,0,31,m,0.00499999988824129
香,487,482,5,f,0.00100000004749745
高,70,0,70,m,0.00100000004749745
剛,306,0,306,m,0.00100000004749745
合,31,31,0,f,0.00100000004749745
豪,46,0,46,m,0.00100000004749745
克,72,0,72,m,0.00100000004749745
根,3,1,2,b,0.510489940643311
佐,23,19,4,f,5.66536262347483E-10
沙,54,54,0,f,0.00100000004749745
瑳,3,1,2,b,0.510489940643311
砂,8,7,1,f,0.000124967264127918
哉,588,0,588,m,0.00100000004749745
彩,54,52,2,f,0.00100000004749745
才,3,1,2,b,0.510489940643311
歳,4,1,3,b,0.614211916923523
采,4,3,1,f,0.0320056080818176
菜,152,152,0,f,0.00100000004749745
冴,5,2,3,b,0.287234365940094
咲,54,52,2,f,0.00100000004749745
作,188,0,188,m,0.00100000004749745
策,17,0,17,m,0.0174575205892324
桜,15,15,0,f,7.79177139476062E-11
三,332,4,328,m,0.00100000004749745
司,1797,0,1797,m,0.00100000004749745
史,1387,4,1383,m,0.00100000004749745
嗣,179,0,179,m,0.00100000004749745
士,368,0,368,m,0.00100000004749745
始,8,1,7,b,0.468950062990189
子,7375,7374,1,f,0.00100000004749745
市,65,0,65,m,0.00100000004749745
志,1261,2,1259,m,0.00100000004749745
枝,174,174,0,f,0.00100000004749745
紫,4,3,1,f,0.0320056080818176
至,56,0,56,m,0.00100000004749745
視,25,4,21,b,0.899999976158142
詞,24,0,24,m,0.0120000001043081
詩,7,1,6,b,0.544257760047913
資,23,0,23,m,0.00418317271396518
児,55,0,55,m,0.00100000004749745
次,428,0,428,m,0.00100000004749745
滋,31,0,31,m,0.00499999988824129
治,1264,0,1264,m,0.00100000004749745
爾,13,0,13,m,0.0452515780925751
七,4,1,3,b,0.614211916923523
実,293,123,170,f,0.00100000004749745
紗,35,35,0,f,0.00100000004749745
若,3,1,2,b,0.510489940643311
守,85,0,85,m,0.00100000004749745
珠,4,3,1,f,0.0320056080818176
寿,105,3,102,m,0.00100000004749745
樹,1958,74,1884,m,0.00100000004749745
周,29,0,29,m,0.00600000005215406
宗,20,0,20,m,0.00854563154280186
修,207,0,207,m,0.00100000004749745
秀,192,1,191,m,0.00100000004749745
秋,70,21,49,b,0.0740000009536743
充,113,1,112,m,0.00100000004749745
重,41,5,36,b,0.899999976158142
淑,8,2,6,b,0.531049966812134
俊,247,1,246,m,0.00100000004749745
春,104,33,71,f,0.00899999961256981
瞬,16,0,16,m,0.0221511032432318
駿,42,0,42,m,0.00100000004749745
旬,5,1,4,b,0.712765634059906
淳,231,1,230,m,0.00100000004749745
準,13,0,13,m,0.0452515780925751
潤,95,1,94,m,0.00100000004749745
純,144,16,128,m,0.00400000018998981
順,33,1,32,m,0.0109999999403954
渚,10,10,0,f,1.82427712047684E-07
緒,52,46,6,f,0.00100000004749745
助,65,0,65,m,0.00100000004749745
女,5,5,0,f,0.000427115563070402
勝,196,0,196,m,0.00100000004749745
匠,51,0,51,m,0.00100000004749745
奨,14,0,14,m,0.0356632508337498
将,103,0,103,m,0.00100000004749745
尚,115,0,115,m,0.00100000004749745
彰,184,1,183,m,0.00100000004749745
昇,88,0,88,m,0.00100000004749745
昌,69,0,69,m,0.00100000004749745
昭,505,1,504,m,0.00100000004749745
晶,63,25,38,f,0.00100000004749745
梢,9,9,0,f,8.60957527493156E-07
渉,69,0,69,m,0.00100000004749745
照,19,1,18,b,0.0662333220243454
祥,31,0,31,m,0.00499999988824129
章,363,2,361,m,0.00100000004749745
笑,2,2,0,f,0.044897086918354
丈,21,0,21,m,0.00673490390181541
城,46,1,45,m,0.00300000002607703
穣,17,0,17,m,0.0174575205892324
譲,22,0,22,m,0.00530784949660301
織,176,169,7,f,0.00100000004749745
伸,190,0,190,m,0.00100000004749745
信,289,0,289,m,0.00100000004749745
心,22,7,15,b,0.167007461190224
慎,40,0,40,m,0.0020000000949949
新,26,0,26,m,0.00899999961256981
晋,42,0,42,m,0.00100000004749745
深,6,1,5,b,0.626161813735962
真,239,4,235,m,0.00100000004749745
臣,82,0,82,m,0.00100000004749745
親,20,1,19,b,0.0544967465102673
進,114,0,114,m,0.00100000004749745
人,1390,1,1389,m,0.00100000004749745
仁,494,1,493,m,0.00100000004749745
尋,59,33,26,f,0.00100000004749745
水,10,1,9,b,0.340981245040894
翠,8,7,1,f,0.000124967264127918
瑞,5,2,3,b,0.287234365940094
崇,143,0,143,m,0.00100000004749745
澄,58,37,21,f,0.00100000004749745
世,98,67,31,f,0.00100000004749745
瀬,3,2,1,b,0.115664832293987
勢,5,1,4,b,0.712765634059906
征,31,0,31,m,0.00499999988824129
成,312,0,312,m,0.00100000004749745
政,44,0,44,m,0.00100000004749745
星,24,6,18,b,0.899999976158142
晴,193,20,173,m,0.00100000004749745
正,306,0,306,m,0.00100000004749745
清,84,0,84,m,0.00100000004749745
生,551,52,499,m,0.00100000004749745
盛,14,0,14,m,0.0356632508337498
聖,68,4,64,m,0.00300000002607703
誠,418,0,418,m,0.00100000004749745
青,5,2,3,b,0.287234365940094
静,5,5,0,f,0.000427115563070402
斉,28,0,28,m,0.00700000021606684
雪,19,18,1,f,1.12565842064205E-11
仙,4,1,3,b,0.614211916923523
千,2,1,1,b,0.378881573677063
宣,72,0,72,m,0.00100000004749745
泉,45,21,24,f,0.00100000004749745
善,36,0,36,m,0.00300000002607703
創,16,0,16,m,0.0221511032432318
壮,13,0,13,m,0.0452515780925751
奏,12,10,2,f,7.85216707299696E-06
想,3,1,2,b,0.510489940643311
操,22,8,14,b,0.0750878602266312
早,6,3,3,b,0.114026740193367
聡,234,1,233,m,0.00100000004749745
草,9,9,0,f,8.60957527493156E-07
蒼,6,2,4,b,0.373838186264038
蔵,42,0,42,m,0.00100000004749745
造,68,0,68,m,0.00100000004749745
則,454,0,454,m,0.00100000004749745
多,20,0,20,m,0.00854563154280186
太,1235,0,1235,m,0.00100000004749745
汰,51,0,51,m,0.00100000004749745
泰,80,1,79,m,0.00100000004749745
代,491,488,3,f,0.00100000004749745
大,461,0,461,m,0.00100000004749745
卓,71,0,71,m,0.00100000004749745
拓,45,0,45,m,0.00100000004749745
達,31,0,31,m,0.00499999988824129
丹,2,1,1,b,0.378881573677063
暖,4,1,3,b,0.614211916923523
男,770,0,770,m,0.00100000004749745
知,46,5,41,b,0.0890000015497208
地,67,0,67,m,0.00100000004749745
智,212,9,203,m,0.00100000004749745
宙,15,1,14,b,0.141456514596939
忠,81,0,81,m,0.00100000004749745
暢,25,0,25,m,0.00999999977648258
潮,3,2,1,b,0.115664832293987
鳥,6,4,2,f,0.0208904650062323
直,113,2,111,m,0.00100000004749745
津,16,14,2,f,2.84073777834237E-08
通,44,0,44,m,0.00100000004749745
鶴,27,25,2,f,0.00100000004749745
貞,4,1,3,b,0.614211916923523
禎,15,0,15,m,0.0281065888702869
摘,15,15,0,f,7.79177139476062E-11
哲,103,0,103,m,0.00100000004749745
徹,254,0,254,m,0.00100000004749745
典,426,3,423,m,0.00100000004749745
展,27,1,26,m,0.0270000007003546
田,2,1,1,b,0.378881573677063
斗,185,0,185,m,0.00100000004749745
渡,18,0,18,m,0.0137584581971169
登,109,0,109,m,0.00100000004749745
都,39,16,23,f,0.00300000002607703
努,54,0,54,m,0.00100000004749745
冬,5,2,3,b,0.287234365940094
桃,6,6,0,f,9.05012275325134E-05
等,31,0,31,m,0.00499999988824129
透,52,0,52,m,0.00100000004749745
瞳,33,32,1,f,0.00100000004749745
道,143,1,142,m,0.00100000004749745
徳,334,1,333,m,0.00100000004749745
篤,77,0,77,m,0.00100000004749745
敦,103,0,103,m,0.00100000004749745
奈,295,292,3,f,0.00100000004749745
那,36,31,5,f,0.00100000004749745
凪,2,2,0,f,0.044897086918354
南,23,22,1,f,2.74007247149039E-14
楠,3,2,1,b,0.115664832293987
二,1455,0,1455,m,0.00100000004749745
日,7,2,5,b,0.455742239952087
忍,58,8,50,b,0.899999976158142
寧,11,2,9,b,0.577963352203369
年,30,1,29,m,0.017000000923872
乃,130,129,1,f,0.00100000004749745
之,1988,0,1988,m,0.00100000004749745
納,2,2,0,f,0.044897086918354
能,7,1,6,b,0.544257760047913
波,20,19,1,f,2.5089327317096E-12
馬,111,0,111,m,0.00100000004749745
博,696,1,695,m,0.00100000004749745
白,2,1,1,b,0.378881573677063
肇,61,0,61,m,0.00100000004749745
八,13,0,13,m,0.0452515780925751
隼,21,0,21,m,0.00673490390181541
帆,60,52,8,f,0.00100000004749745
繁,52,0,52,m,0.00100000004749745
範,108,0,108,m,0.00100000004749745
妃,11,10,1,f,1.62015999194409E-06
微,2,2,0,f,0.044897086918354
美,2261,2020,241,f,0.00100000004749745
彦,1688,0,1688,m,0.00100000004749745
姫,16,16,0,f,1.65099323101714E-11
苗,66,65,1,f,0.00100000004749745
彬,19,1,18,b,0.0662333220243454
敏,185,1,184,m,0.00100000004749745
夫,1232,0,1232,m,0.00100000004749745
富,13,1,12,b,0.203412413597107
布,4,2,2,b,0.199324056506157
武,137,0,137,m,0.00100000004749745
舞,30,29,1,f,0.00100000004749745
楓,16,13,3,f,5.04145248214627E-07
風,5,2,3,b,0.287234365940094
文,539,10,529,m,0.00100000004749745
平,1063,0,1063,m,0.00100000004749745
並,2,2,0,f,0.044897086918354
碧,9,8,1,f,2.96815142064588E-05
勉,134,0,134,m,0.00100000004749745
保,149,83,66,f,0.00100000004749745
歩,86,38,48,f,0.00100000004749745
輔,654,2,652,m,0.00100000004749745
穂,203,182,21,f,0.00100000004749745
峰,13,1,12,b,0.203412413597107
朋,14,2,12,b,0.40448796749115
法,23,0,23,m,0.00418317271396518
芳,45,6,39,b,0.899999976158142
萌,14,13,1,f,1.95161646843189E-08
豊,183,1,182,m,0.00100000004749745
邦,35,0,35,m,0.00300000002607703
房,13,0,13,m,0.0452515780925751
望,63,25,38,f,0.00100000004749745
牧,6,5,1,f,0.0021101871971041
睦,28,9,19,b,0.899999976158142
磨,90,0,90,m,0.00100000004749745
麻,21,10,11,f,0.00629237620159984
繭,2,2,0,f,0.044897086918354
麿,7,1,6,b,0.544257760047913
満,85,1,84,m,0.00100000004749745
未,42,38,4,f,0.00100000004749745
巳,154,10,144,m,0.00100000004749745
岬,6,4,2,f,0.0208904650062323
稔,133,0,133,m,0.00100000004749745
妙,6,6,0,f,9.05012275325134E-05
民,6,1,5,b,0.626161813735962
務,23,0,23,m,0.00418317271396518
夢,50,13,37,b,0.899999976158142
名,8,4,4,b,0.0678428560495377
明,1273,13,1260,m,0.00100000004749745
茂,175,0,175,m,0.00100000004749745
猛,60,0,60,m,0.00100000004749745
木,3,1,2,b,0.510489940643311
紋,3,3,0,f,0.00951321329921484
也,2310,3,2307,m,0.00100000004749745
耶,28,16,12,f,0.00100000004749745
野,22,15,7,f,2.83487861452159E-06
弥,237,28,209,m,0.00100000004749745
矢,118,8,110,m,0.00100000004749745
靖,90,0,90,m,0.00100000004749745
諭,31,0,31,m,0.00499999988824129
唯,22,16,6,f,3.25402112366646E-07
佑,129,1,128,m,0.00100000004749745
優,114,30,84,b,0.899999976158142
勇,66,0,66,m,0.00100000004749745
友,45,5,40,b,0.100000001490116
悠,39,13,26,b,0.0649999976158142
憂,2,2,0,f,0.044897086918354
有,16,4,12,b,0.449346750974655
由,49,20,29,f,0.00100000004749745
祐,271,2,269,m,0.00100000004749745
裕,462,10,452,m,0.00100000004749745
雄,1060,0,1060,m,0.00100000004749745
予,2,2,0,f,0.044897086918354
与,4,2,2,b,0.199324056506157
誉,20,2,18,b,0.171862542629242
容,2,2,0,f,0.044897086918354
曜,2,1,1,b,0.378881573677063
洋,406,1,405,m,0.00100000004749745
葉,31,28,3,f,0.00100000004749745
要,36,1,35,m,0.00800000037997961
遥,16,14,2,f,2.84073777834237E-08
陽,61,6,55,m,0.0299999993294477
翼,67,0,67,m,0.00100000004749745
羅,4,1,3,b,0.614211916923523
来,36,27,9,f,0.00100000004749745
藍,7,6,1,f,0.000518451153766364
蘭,7,7,0,f,1.91762446775101E-05
利,177,21,156,m,0.00300000002607703
吏,15,0,15,m,0.0281065888702869
李,8,7,1,f,0.000124967264127918
梨,36,36,0,f,0.00100000004749745
理,199,122,77,f,0.00100000004749745
璃,5,3,2,b,0.0674585998058319
里,335,325,10,f,0.00100000004749745
陸,23,0,23,m,0.00418317271396518
律,9,1,8,b,0.401120543479919
留,9,5,4,f,0.0249415636062622
隆,426,0,426,m,0.00100000004749745
竜,18,0,18,m,0.0137584581971169
龍,23,0,23,m,0.00418317271396518
了,13,0,13,m,0.0452515780925751
亮,273,1,272,m,0.00100000004749745
凌,16,0,16,m,0.0221511032432318
涼,37,2,35,m,0.0189999993890524
良,151,7,144,m,0.00100000004749745
諒,41,1,40,m,0.00400000018998981
遼,28,1,27,m,0.0230000000447035
陵,5,1,4,b,0.712765634059906
力,64,0,64,m,0.00100000004749745
緑,12,12,0,f,8.19047318856292E-09
倫,35,1,34,m,0.00899999961256981
林,11,5,6,b,0.0627967044711113
琳,3,2,1,b,0.115664832293987
輪,3,2,1,b,0.115664832293987
瑠,9,4,5,b,0.102163895964622
塁,14,1,13,b,0.169899821281433
累,2,1,1,b,0.378881573677063
怜,14,5,9,b,0.156701728701591
玲,18,7,11,b,0.0672688782215118
礼,13,1,12,b,0.203412413597107
鈴,25,25,0,f,0.00100000004749745
麗,13,12,1,f,8.56504627222421E-08
恋,2,2,0,f,0.044897086918354
蓮,13,4,9,b,0.289935559034348
路,33,2,31,m,0.034000001847744
朗,503,0,503,m,0.00100000004749745
郎,2218,0,2218,m,0.00100000004749745
和,657,60,597,m,0.00100000004749745
亘,41,0,41,m,0.00100000004749745
侑,10,6,4,f,0.00857897475361824
來,4,3,1,f,0.0320056080818176
凛,6,5,1,f,0.0021101871971041
娟,2,2,0,f,0.044897086918354
實,6,1,5,b,0.626161813735962
廣,37,0,37,m,0.00300000002607703
惠,19,17,2,f,3.82813114541136E-10
暉,21,0,21,m,0.00673490390181541
栞,8,8,0,f,4.06324170398875E-06
椰,4,1,3,b,0.614211916923523
澪,3,3,0,f,0.00951321329921484
煌,2,1,1,b,0.378881573677063
瑶,2,1,1,b,0.378881573677063
眞,20,0,20,m,0.00854563154280186
綺,5,2,3,b,0.287234365940094
翔,162,1,161,m,0.00100000004749745
茉,2,1,1,b,0.378881573677063
莉,33,32,1,f,0.00100000004749745
蕾,2,2,0,f,0.044897086918354
遙,2,2,0,f,0.044897086918354
凜,7,6,1,f,0.000518451153766364
琦,2,1,1,b,0.378881573677063
々,37,34,3,f,0.00100000004749745
